...O..#K..
...#..#...
...#*.#...
####O##...
......#...
......L...
#O#####...
..#...#...
..#...#...
K.^...#...