!$!$!$#R.@
$.....##O#
!.....#...
......L..Z
#O######O#
..#..*#...
K.^...#..B