*..O..#..@
####O##...
......#R..
......L...
#O#####...
..#..*#..B
K.^...#..Z