*..O..#K..
####O##...
......#...
......L...
#O#####...
..#..*#..B
K.^...#...