WWWWWWWWWW
WWWWWWWWWW
WWW$$$$WWW
WWW$T.$WWW
WWW$$$$WWW
WWWWWWWWWW
WWWWWWWWWW