!.S.!.S.!.
.....$....
.$.......!
...T.S.$..
!.........
....$....!
S.!...!.S.