!.@.!.@.!.
.....$....
.$.......!
...T.@.$..
!.........
....$....!
@.!...!.@.